1111111111111111111111111111111111
1E00000000000000000000000000000001
10000000000000000000000000000000P1
10000000000000000000000000000000C1
1111111111111111111111111111111111