111111111111111111111111111111111111111111
1E000000000010000000000001C11C10P0000C1C01
1000100000011100000000100C1CC1C1000001C101
10000000000010000000000000C11C10000001C101
111111111111111111111111111111111111111111