111111111111111111
10010000000C000001
100001111111111101
1P0011E00000000001
111111111111111111